3 rounds of decks
Packs have 7 cards

1 Basic trio - easy one-card starters:
PMTN - Poetic Motion - Onamat - EARTH Xyz
FRSN - Frozen Song - Windwitch - WIND Synchro
RMJS - Resonant Majesty - Orcust  - DARK Link

2 Old:
DERD - Dead-heat Riders - Speedroid - WIND Synchro
DYLG - Dynastic Legacy - Six Samurai - All Attribute ???
ETHR - Eternal Honor - Phantom Knight - DARK Xyz

3 Main deck trio:
GTRS - Glorious Treasure - Eldlich - LIGHT main deck
LVAM - Living Anamolies - Danger - DARK main deck
RIGN - Redhot Ignition - Metalfoes - FIRE Pendulum

4 Multi-attribute Links trio:
NWSS - Network Superstars - Evil Twin  - LIGHT/DARK Link
EVAR - Evolving Arsenal - Sky Striker - All attribute Link
WTRK - Wily Tricksters - Prank-kids - All attribute Link

X Finished:
BZWL - Blazing Will - Salamangreat - FIRE Link
AMSL - Armored Soul - Masked Heroes - All attribute Fusion
STPV - Stone Providence - Megalith - EARTH Ritual
SUNV - Silent Universe - Silent Psychics - EARTH Synchro. Really does not work
Kozmo - Star Wanderers - Kozmo - CHAOS main deck

Other ideas:
Blackwings
Nepthys
Mathmech
Dragonmaid
Rokket

Magistus
Exorsister

Dinomist - WATER Pendulum
Majespecter - WIND Pendulum
Igknight - FIRE Pendulum

Crystron - WATER Synchro

Drytron - LIGHT Xyz/Ritual
Adamancipator - EARTH Synchro

Time Thief - DARK Xyz
Dogmatika



